;Stimmart;Adresse;Bezirksnummer;Bezirksname;Abstimmungsbezirk;Abstimmungsbezirksart;Briefabstimmungsbezirk;Abgeordnetenhauswahlkreis;Bundestagswahlkreis;OstWest;Abstimmungsberechtigte insgesamt;Abstimmungsberechtigte A1;Abstimmungsberechtigte A2;Abstimmungsberechtigte A3;Teilnehmende;Teilnehmende B1;Ungültige Stimmen;Gültige Stimmen;Stimmabgabe Volksentscheid: Ja;Stimmabgabe Volksentscheid: Nein;aufn;Group 2
;Stimme;02W101;02;Friedrichshain-Kreuzberg;101;W;021A;01;83;W;1059;915;144;0;173;3;0;173;110;63;;Group 1
;Stimme;02W102;02;Friedrichshain-Kreuzberg;102;W;021B;01;83;W;1208;1071;137;0;148;1;3;145;93;52;;Group 1
;Stimme;02W103;02;Friedrichshain-Kreuzberg;103;W;021C;01;83;W;1029;939;90;0;95;1;0;95;52;43;;Group 1
;Stimme;02W104;02;Friedrichshain-Kreuzberg;104;W;021D;01;83;W;704;609;95;0;96;3;1;95;59;36;;Group 1
;Stimme;02W105;02;Friedrichshain-Kreuzberg;105;W;021E;01;83;W;1015;903;112;0;145;8;0;145;85;60;;Group 1
;Stimme;02W106;02;Friedrichshain-Kreuzberg;106;W;021F;01;83;W;1472;1272;200;0;175;3;1;174;121;53;;Group 1
;Stimme;02W107;02;Friedrichshain-Kreuzberg;107;W;021G;01;83;W;610;499;111;0;138;3;1;137;106;31;;Group 1
;Stimme;02W108;02;Friedrichshain-Kreuzberg;108;W;021G;01;83;W;762;512;250;0;115;6;3;112;80;32;;Group 1
;Stimme;02W109;02;Friedrichshain-Kreuzberg;109;W;021H;01;83;W;1182;916;266;0;274;3;1;273;220;53;;Group 1
;Stimme;02W110;02;Friedrichshain-Kreuzberg;110;W;021J;01;83;W;1088;814;274;0;219;4;0;219;181;38;;Group 1
;Stimme;02W111;02;Friedrichshain-Kreuzberg;111;W;021K;01;83;W;1121;882;239;0;245;3;0;245;211;34;;Group 1
;Stimme;02W112;02;Friedrichshain-Kreuzberg;112;W;021L;01;83;W;1302;1022;280;0;281;8;0;281;218;63;;Group 1
;Stimme;02W113;02;Friedrichshain-Kreuzberg;113;W;021M;01;83;W;942;713;229;0;281;8;4;277;222;55;;Group 1
;Stimme;02W114;02;Friedrichshain-Kreuzberg;114;W;021N;01;83;W;805;617;188;0;247;7;5;242;200;42;;Group 1
;Stimme;02W115;02;Friedrichshain-Kreuzberg;115;W;021N;01;83;W;816;627;189;0;240;6;1;239;195;44;;Group 1
;Stimme;02W116;02;Friedrichshain-Kreuzberg;116;W;021P;01;83;W;1015;771;244;0;282;11;1;281;222;59;;Group 1
;Stimme;02W117;02;Friedrichshain-Kreuzberg;117;W;021Q;01;83;W;1047;806;241;0;272;9;1;271;222;49;;Group 1
;Stimme;02W118;02;Friedrichshain-Kreuzberg;118;W;021R;01;83;W;662;534;128;0;149;2;0;149;110;39;;Group 1
;Stimme;02W119;02;Friedrichshain-Kreuzberg;119;W;021S;01;83;W;831;613;218;0;202;9;3;199;146;53;;Group 1
;Stimme;02W120;02;Friedrichshain-Kreuzberg;120;W;021T;01;83;W;797;642;155;0;202;4;1;201;159;42;;Group 1
;Stimme;02W121;02;Friedrichshain-Kreuzberg;121;W;021U;01;83;W;847;694;153;0;257;16;3;254;199;55;;Group 1
;Stimme;02W122;02;Friedrichshain-Kreuzberg;122;W;021V;01;83;W;1019;810;209;0;284;10;0;284;233;51;;Group 1
;Stimme;02W123;02;Friedrichshain-Kreuzberg;123;W;021R;01;83;W;719;574;145;0;194;6;1;193;153;40;;Group 1
;Stimme;02W124;02;Friedrichshain-Kreuzberg;124;W;021W;01;83;W;1290;965;325;0;354;16;3;351;287;64;;Group 1
;Stimme;02W125;02;Friedrichshain-Kreuzberg;125;W;021X;01;83;W;1325;955;370;0;451;5;5;446;377;69;;Group 1
;Stimme;02W126;02;Friedrichshain-Kreuzberg;126;W;021Y;01;83;W;904;690;214;0;287;20;1;286;237;49;;Group 1
;Stimme;02W127;02;Friedrichshain-Kreuzberg;127;W;021Z;01;83;W;852;668;184;0;206;11;2;204;178;26;;Group 1
;Stimme;02W128;02;Friedrichshain-Kreuzberg;128;W;021AA;01;83;W;1219;870;349;0;287;11;4;283;233;50;;Group 1
;Stimme;02W129;02;Friedrichshain-Kreuzberg;129;W;021AB;01;83;W;1222;864;358;0;302;4;1;301;217;84;;Group 1
;Stimme;02W201;02;Friedrichshain-Kreuzberg;201;W;022A;02;83;W;851;689;162;0;236;1;1;235;187;48;;Group 1
;Stimme;02W202;02;Friedrichshain-Kreuzberg;202;W;022B;02;83;W;1054;825;229;0;310;9;0;310;261;49;;Group 1
;Stimme;02W203;02;Friedrichshain-Kreuzberg;203;W;022C;02;83;W;890;704;186;0;252;5;2;250;213;37;;Group 1
;Stimme;02W204;02;Friedrichshain-Kreuzberg;204;W;022D;02;83;W;1030;835;195;0;252;6;1;251;222;29;;Group 1
;Stimme;02W205;02;Friedrichshain-Kreuzberg;205;W;022E;02;83;W;993;803;190;0;225;4;1;224;192;32;;Group 1
;Stimme;02W206;02;Friedrichshain-Kreuzberg;206;W;022F;02;83;W;949;773;176;0;266;8;1;265;223;42;;Group 1
;Stimme;02W207;02;Friedrichshain-Kreuzberg;207;W;022G;02;83;W;1332;1098;234;0;366;11;3;363;295;68;;Group 1
;Stimme;02W208;02;Friedrichshain-Kreuzberg;208;W;022H;02;83;W;1115;887;228;0;320;8;0;320;256;64;;Group 1
;Stimme;02W209;02;Friedrichshain-Kreuzberg;209;W;022J;02;83;W;1115;890;225;0;274;10;2;272;218;54;;Group 1
;Stimme;02W210;02;Friedrichshain-Kreuzberg;210;W;022K;02;83;W;1111;872;239;0;276;1;2;274;240;34;;Group 1
;Stimme;02W211;02;Friedrichshain-Kreuzberg;211;W;022L;02;83;W;1110;885;225;0;287;10;0;287;239;48;;Group 1
;Stimme;02W212;02;Friedrichshain-Kreuzberg;212;W;022M;02;83;W;903;705;198;0;276;3;3;273;232;41;;Group 1
;Stimme;02W213;02;Friedrichshain-Kreuzberg;213;W;022N;02;83;W;1092;879;213;0;283;13;1;282;244;38;;Group 1
;Stimme;02W214;02;Friedrichshain-Kreuzberg;214;W;022P;02;83;W;920;778;142;0;170;4;0;170;129;41;;Group 1
;Stimme;02W215;02;Friedrichshain-Kreuzberg;215;W;022Q;02;83;W;896;826;70;0;160;2;0;160;88;72;;Group 1
;Stimme;02W216;02;Friedrichshain-Kreuzberg;216;W;022Q;02;83;W;840;640;200;0;294;3;1;293;245;48;;Group 1
;Stimme;02W217;02;Friedrichshain-Kreuzberg;217;W;022R;02;83;W;1045;794;251;0;269;5;2;267;239;28;;Group 1
;Stimme;02W218;02;Friedrichshain-Kreuzberg;218;W;022S;02;83;W;1145;887;258;0;350;12;3;347;307;40;;Group 1
;Stimme;02W219;02;Friedrichshain-Kreuzberg;219;W;022T;02;83;W;935;750;185;0;241;7;2;239;210;29;;Group 1
;Stimme;02W220;02;Friedrichshain-Kreuzberg;220;W;022U;02;83;W;1120;872;248;0;306;10;3;303;257;46;;Group 1
;Stimme;02W221;02;Friedrichshain-Kreuzberg;221;W;022V;02;83;W;894;716;178;0;207;6;1;206;180;26;;Group 1
;Stimme;02W222;02;Friedrichshain-Kreuzberg;222;W;022W;02;83;W;1095;888;207;0;285;13;4;281;216;65;;Group 1
;Stimme;02W223;02;Friedrichshain-Kreuzberg;223;W;022X;02;83;W;840;752;88;0;123;5;0;123;86;37;;Group 1
;Stimme;02W224;02;Friedrichshain-Kreuzberg;224;W;022Y;02;83;W;917;688;229;0;214;9;0;214;177;37;;Group 1
;Stimme;02W225;02;Friedrichshain-Kreuzberg;225;W;022Y;02;83;W;700;490;210;0;177;12;0;177;134;43;;Group 1
;Stimme;02W226;02;Friedrichshain-Kreuzberg;226;W;022Z;02;83;W;1293;953;340;0;375;9;0;375;284;91;;Group 1
;Stimme;02W301;02;Friedrichshain-Kreuzberg;301;W;023A;03;83;W;1083;843;240;0;358;13;1;357;315;42;;Group 1
;Stimme;02W302;02;Friedrichshain-Kreuzberg;302;W;023B;03;83;W;1203;873;330;0;369;13;0;369;288;81;;Group 1
;Stimme;02W303;02;Friedrichshain-Kreuzberg;303;W;023C;03;83;W;1179;912;267;0;300;10;1;299;237;62;;Group 1
;Stimme;02W304;02;Friedrichshain-Kreuzberg;304;W;023D;03;83;W;1091;825;266;0;290;8;1;289;243;46;;Group 1
;Stimme;02W305;02;Friedrichshain-Kreuzberg;305;W;023E;03;83;W;1100;863;237;0;340;6;0;340;285;55;;Group 1
;Stimme;02W306;02;Friedrichshain-Kreuzberg;306;W;023F;03;83;W;1032;835;197;0;263;4;1;262;211;51;;Group 1
;Stimme;02W307;02;Friedrichshain-Kreuzberg;307;W;023G;03;83;W;809;733;76;0;117;2;0;117;78;39;;Group 1
;Stimme;02W308;02;Friedrichshain-Kreuzberg;308;W;023H;03;83;W;1192;1023;169;0;200;3;1;199;134;65;;Group 1
;Stimme;02W309;02;Friedrichshain-Kreuzberg;309;W;023J;03;83;W;810;688;122;0;144;1;1;143;101;42;;Group 1
;Stimme;02W310;02;Friedrichshain-Kreuzberg;310;W;023K;03;83;W;1236;1052;184;0;216;8;0;216;132;84;;Group 1
;Stimme;02W311;02;Friedrichshain-Kreuzberg;311;W;023L;03;83;W;1168;1001;167;0;184;4;1;183;115;68;;Group 1
;Stimme;02W312;02;Friedrichshain-Kreuzberg;312;W;023M;03;83;W;766;668;98;0;116;2;0;116;70;46;;Group 1
;Stimme;02W313;02;Friedrichshain-Kreuzberg;313;W;023M;03;83;W;829;735;94;0;95;1;0;95;56;39;;Group 1
;Stimme;02W314;02;Friedrichshain-Kreuzberg;314;W;023N;03;83;W;1178;1048;130;0;120;1;0;120;48;72;;Group 1
;Stimme;02W315;02;Friedrichshain-Kreuzberg;315;W;023P;03;83;W;947;820;127;0;115;2;0;115;76;39;;Group 1
;Stimme;02W316;02;Friedrichshain-Kreuzberg;316;W;023Q;03;83;W;1206;1102;104;0;139;2;0;139;77;62;;Group 1
;Stimme;02W317;02;Friedrichshain-Kreuzberg;317;W;023R;03;83;W;1260;1045;215;0;246;7;1;245;213;32;;Group 1
;Stimme;02W318;02;Friedrichshain-Kreuzberg;318;W;023S;03;83;W;914;759;155;0;172;1;1;171;140;31;;Group 1
;Stimme;02W319;02;Friedrichshain-Kreuzberg;319;W;023T;03;83;W;943;743;200;0;264;3;1;263;225;38;;Group 1
;Stimme;02W320;02;Friedrichshain-Kreuzberg;320;W;023U;03;83;W;1028;842;186;0;190;4;0;190;161;29;;Group 1
;Stimme;02W321;02;Friedrichshain-Kreuzberg;321;W;023V;03;83;W;908;774;134;0;208;6;1;207;176;31;;Group 1
;Stimme;02W322;02;Friedrichshain-Kreuzberg;322;W;023W;03;83;W;983;856;127;0;166;2;3;163;126;37;;Group 1
;Stimme;02W323;02;Friedrichshain-Kreuzberg;323;W;023X;03;83;W;1111;922;189;0;307;9;0;307;231;76;;Group 1
;Stimme;02W324;02;Friedrichshain-Kreuzberg;324;W;023Y;03;83;W;1137;907;230;0;321;7;2;319;271;48;;Group 1
;Stimme;02W325;02;Friedrichshain-Kreuzberg;325;W;023Z;03;83;W;1109;959;150;0;206;5;0;206;145;61;;Group 1
;Stimme;02W326;02;Friedrichshain-Kreuzberg;326;W;023AA;03;83;W;1071;844;227;0;316;8;1;315;268;47;;Group 1
;Stimme;02W327;02;Friedrichshain-Kreuzberg;327;W;023AB;03;83;W;880;700;180;0;244;0;3;241;197;44;;Group 1
;Stimme;02W401;02;Friedrichshain-Kreuzberg;401;W;024A;04;83;O;1107;946;161;0;164;4;0;164;76;88;;Group 1
;Stimme;02W402;02;Friedrichshain-Kreuzberg;402;W;024B;04;83;O;1099;926;173;0;209;1;0;209;89;120;;Group 1
;Stimme;02W403;02;Friedrichshain-Kreuzberg;403;W;024C;04;83;O;1248;1068;180;0;144;3;2;142;83;59;;Group 1
;Stimme;02W404;02;Friedrichshain-Kreuzberg;404;W;024D;04;83;O;1072;888;184;0;172;2;0;172;89;83;;Group 1
;Stimme;02W405;02;Friedrichshain-Kreuzberg;405;W;024E;04;83;O;861;646;215;0;189;3;0;189;115;74;;Group 1
;Stimme;02W406;02;Friedrichshain-Kreuzberg;406;W;024F;04;83;O;978;775;203;0;216;7;0;216;146;70;;Group 1
;Stimme;02W407;02;Friedrichshain-Kreuzberg;407;W;024G;04;83;O;784;632;152;0;181;4;0;181;121;60;;Group 1
;Stimme;02W408;02;Friedrichshain-Kreuzberg;408;W;024H;04;83;O;874;644;230;0;178;6;1;177;134;43;;Group 1
;Stimme;02W409;02;Friedrichshain-Kreuzberg;409;W;024J;04;83;O;1060;838;222;0;174;6;0;174;108;66;;Group 1
;Stimme;02W410;02;Friedrichshain-Kreuzberg;410;W;024K;04;83;O;1022;726;296;0;287;6;2;285;193;92;;Group 1
;Stimme;02W411;02;Friedrichshain-Kreuzberg;411;W;024L;04;83;O;1132;938;194;0;234;2;1;233;150;83;;Group 1
;Stimme;02W412;02;Friedrichshain-Kreuzberg;412;W;024M;04;83;O;1062;825;237;0;252;5;2;250;181;69;;Group 1
;Stimme;02W413;02;Friedrichshain-Kreuzberg;413;W;024N;04;83;O;911;691;220;0;194;3;2;192;136;56;;Group 1
;Stimme;02W414;02;Friedrichshain-Kreuzberg;414;W;024P;04;83;O;947;712;235;0;206;5;1;205;164;41;;Group 1
;Stimme;02W415;02;Friedrichshain-Kreuzberg;415;W;024Q;04;83;O;1160;906;254;0;282;9;0;282;193;89;;Group 1
;Stimme;02W416;02;Friedrichshain-Kreuzberg;416;W;024R;04;83;O;1300;1036;264;0;301;1;2;299;185;114;;Group 1
;Stimme;02W417;02;Friedrichshain-Kreuzberg;417;W;024S;04;83;O;1045;848;197;0;251;1;2;249;169;80;;Group 1
;Stimme;02W418;02;Friedrichshain-Kreuzberg;418;W;024T;04;83;O;1154;982;172;0;139;1;0;139;64;75;;Group 1
;Stimme;02W419;02;Friedrichshain-Kreuzberg;419;W;024U;04;83;O;1281;1073;208;0;228;3;0;228;129;99;;Group 1
;Stimme;02W420;02;Friedrichshain-Kreuzberg;420;W;024V;04;83;O;779;658;121;0;139;1;0;139;73;66;;Group 1
;Stimme;02W421;02;Friedrichshain-Kreuzberg;421;W;024W;04;83;O;926;785;141;0;144;5;0;144;76;68;;Group 1
;Stimme;02W422;02;Friedrichshain-Kreuzberg;422;W;024X;04;83;O;827;666;161;0;169;3;0;169;93;76;;Group 1
;Stimme;02W423;02;Friedrichshain-Kreuzberg;423;W;024Y;04;83;O;1095;934;161;0;135;0;0;135;82;53;;Group 1
;Stimme;02W424;02;Friedrichshain-Kreuzberg;424;W;024Z;04;83;O;852;679;173;0;172;1;1;171;109;62;;Group 1
;Stimme;02W425;02;Friedrichshain-Kreuzberg;425;W;024AA;04;83;O;1160;865;295;0;309;11;0;309;248;61;;Group 1
;Stimme;02W426;02;Friedrichshain-Kreuzberg;426;W;024AB;04;83;O;1131;820;311;0;318;12;2;316;250;66;;Group 1
;Stimme;02W427;02;Friedrichshain-Kreuzberg;427;W;024AC;04;83;O;1058;842;216;0;177;2;0;177;114;63;;Group 1
;Stimme;02W501;02;Friedrichshain-Kreuzberg;501;W;025A;05;83;O;911;693;218;0;224;15;2;222;168;54;;Group 1
;Stimme;02W502;02;Friedrichshain-Kreuzberg;502;W;025B;05;83;O;1269;955;314;0;258;2;0;258;197;61;;Group 1
;Stimme;02W503;02;Friedrichshain-Kreuzberg;503;W;025C;05;83;O;1217;942;275;0;232;8;0;232;186;46;;Group 1
;Stimme;02W504;02;Friedrichshain-Kreuzberg;504;W;025D;05;83;O;1057;816;241;0;261;2;0;261;191;70;;Group 1
;Stimme;02W505;02;Friedrichshain-Kreuzberg;505;W;025E;05;83;O;1237;919;318;0;312;5;2;310;244;66;;Group 1
;Stimme;02W506;02;Friedrichshain-Kreuzberg;506;W;025F;05;83;O;1115;852;263;0;229;3;1;228;176;52;;Group 1
;Stimme;02W507;02;Friedrichshain-Kreuzberg;507;W;025G;05;83;O;1202;864;338;0;259;7;1;258;203;55;;Group 1
;Stimme;02W508;02;Friedrichshain-Kreuzberg;508;W;025H;05;83;O;1278;1039;239;0;280;7;2;278;201;77;;Group 1
;Stimme;02W509;02;Friedrichshain-Kreuzberg;509;W;025J;05;83;O;1004;802;202;0;279;7;2;277;200;77;;Group 1
;Stimme;02W510;02;Friedrichshain-Kreuzberg;510;W;025K;05;83;O;935;733;202;0;190;7;1;189;140;49;;Group 1
;Stimme;02W511;02;Friedrichshain-Kreuzberg;511;W;025L;05;83;O;788;573;215;0;169;6;0;169;145;24;;Group 1
;Stimme;02W512;02;Friedrichshain-Kreuzberg;512;W;025L;05;83;O;934;729;205;0;271;4;1;270;216;54;;Group 1
;Stimme;02W513;02;Friedrichshain-Kreuzberg;513;W;025M;05;83;O;1205;910;295;0;321;9;1;320;269;51;;Group 1
;Stimme;02W514;02;Friedrichshain-Kreuzberg;514;W;025N;05;83;O;969;754;215;0;248;2;1;247;207;40;;Group 1
;Stimme;02W515;02;Friedrichshain-Kreuzberg;515;W;025P;05;83;O;1031;778;253;0;232;3;0;232;204;28;;Group 1
;Stimme;02W516;02;Friedrichshain-Kreuzberg;516;W;025Q;05;83;O;979;736;243;0;185;5;0;185;158;27;;Group 1
;Stimme;02W517;02;Friedrichshain-Kreuzberg;517;W;025R;05;83;O;1229;943;286;0;311;7;1;310;257;53;;Group 1
;Stimme;02W518;02;Friedrichshain-Kreuzberg;518;W;025S;05;83;O;1196;878;318;0;247;7;2;245;191;54;;Group 1
;Stimme;02W519;02;Friedrichshain-Kreuzberg;519;W;025T;05;83;O;1020;745;275;0;255;5;1;254;199;55;;Group 1
;Stimme;02W520;02;Friedrichshain-Kreuzberg;520;W;025U;05;83;O;1202;928;274;0;308;2;1;307;230;77;;Group 1
;Stimme;02W521;02;Friedrichshain-Kreuzberg;521;W;025V;05;83;O;1022;790;232;0;267;8;1;266;209;57;;Group 1
;Stimme;02W522;02;Friedrichshain-Kreuzberg;522;W;025W;05;83;O;1181;921;260;0;238;3;1;237;181;56;;Group 1
;Stimme;02W523;02;Friedrichshain-Kreuzberg;523;W;025X;05;83;O;1041;832;209;0;242;6;1;241;185;56;;Group 1
;Stimme;02W524;02;Friedrichshain-Kreuzberg;524;W;025Y;05;83;O;1033;840;193;0;238;5;1;237;171;66;;Group 1
;Stimme;02W525;02;Friedrichshain-Kreuzberg;525;W;025Z;05;83;O;988;798;190;0;237;4;1;236;186;50;;Group 1
;Stimme;02W526;02;Friedrichshain-Kreuzberg;526;W;025AA;05;83;O;1153;923;230;0;312;7;0;312;254;58;;Group 1
;Stimme;02W601;02;Friedrichshain-Kreuzberg;601;W;026A;06;83;O;1309;1016;293;0;317;12;0;317;213;104;;Group 1
;Stimme;02W602;02;Friedrichshain-Kreuzberg;602;W;026B;06;83;O;885;666;219;0;222;6;0;222;140;82;;Group 1
;Stimme;02W603;02;Friedrichshain-Kreuzberg;603;W;026C;06;83;O;1098;845;253;0;289;4;1;288;220;68;;Group 1
;Stimme;02W604;02;Friedrichshain-Kreuzberg;604;W;026D;06;83;O;999;841;158;0;197;3;0;197;119;78;;Group 1
;Stimme;02W605;02;Friedrichshain-Kreuzberg;605;W;026E;06;83;O;1215;939;276;0;264;6;0;264;212;52;;Group 1
;Stimme;02W606;02;Friedrichshain-Kreuzberg;606;W;026F;06;83;O;795;598;197;0;194;6;0;194;164;30;;Group 1
;Stimme;02W607;02;Friedrichshain-Kreuzberg;607;W;026G;06;83;O;854;654;200;0;281;0;2;279;217;62;;Group 1
;Stimme;02W608;02;Friedrichshain-Kreuzberg;608;W;026H;06;83;O;1181;883;298;0;295;9;0;295;236;59;;Group 1
;Stimme;02W609;02;Friedrichshain-Kreuzberg;609;W;026J;06;83;O;1094;822;272;0;245;7;0;245;205;40;;Group 1
;Stimme;02W610;02;Friedrichshain-Kreuzberg;610;W;026K;06;83;O;1245;967;278;0;338;9;0;338;252;86;;Group 1
;Stimme;02W611;02;Friedrichshain-Kreuzberg;611;W;026L;06;83;O;959;712;247;0;257;6;1;256;205;51;;Group 1
;Stimme;02W612;02;Friedrichshain-Kreuzberg;612;W;026M;06;83;O;1038;786;252;0;284;8;0;284;237;47;;Group 1
;Stimme;02W613;02;Friedrichshain-Kreuzberg;613;W;026N;06;83;O;1177;821;356;0;288;6;2;286;253;33;;Group 1
;Stimme;02W614;02;Friedrichshain-Kreuzberg;614;W;026P;06;83;O;1198;942;256;0;316;3;0;316;249;67;;Group 1
;Stimme;02W615;02;Friedrichshain-Kreuzberg;615;W;026Q;06;83;O;731;591;140;0;160;1;0;160;133;27;;Group 1
;Stimme;02W616;02;Friedrichshain-Kreuzberg;616;W;026R;06;83;O;1177;938;239;0;293;2;0;293;224;69;;Group 1
;Stimme;02W617;02;Friedrichshain-Kreuzberg;617;W;026S;06;83;O;1133;868;265;0;267;8;0;267;219;48;;Group 1
;Stimme;02W618;02;Friedrichshain-Kreuzberg;618;W;026T;06;83;O;962;764;198;0;239;4;0;239;203;36;;Group 1
;Stimme;02W619;02;Friedrichshain-Kreuzberg;619;W;026U;06;83;O;812;622;190;0;205;4;1;204;174;30;;Group 1
;Stimme;02W620;02;Friedrichshain-Kreuzberg;620;W;026V;06;83;O;1033;758;275;0;192;6;2;190;159;31;;Group 1
;Stimme;02W621;02;Friedrichshain-Kreuzberg;621;W;026W;06;83;O;788;584;204;0;171;4;0;171;141;30;;Group 1
;Stimme;02W622;02;Friedrichshain-Kreuzberg;622;W;026X;06;83;O;981;748;233;0;194;1;0;194;148;46;;Group 1
;Stimme;02W623;02;Friedrichshain-Kreuzberg;623;W;026Y;06;83;O;888;642;246;0;209;6;1;208;175;33;;Group 1
;Stimme;02W624;02;Friedrichshain-Kreuzberg;624;W;026Z;06;83;O;883;638;245;0;201;1;1;200;178;22;;Group 1
;Stimme;02W625;02;Friedrichshain-Kreuzberg;625;W;026AA;06;83;O;691;521;170;0;195;4;0;195;157;38;;Group 1
;Stimme;02W626;02;Friedrichshain-Kreuzberg;626;W;026AA;06;83;O;977;730;247;0;255;8;2;253;207;46;;Group 1
;Stimme;02W627;02;Friedrichshain-Kreuzberg;627;W;026G;06;83;O;758;595;163;0;196;4;0;196;147;49;;Group 1
;Stimme;02W628;02;Friedrichshain-Kreuzberg;628;W;026AB;06;83;O;903;656;247;0;205;1;1;204;161;43;;Group 1
;Stimme;02B1A;02;Friedrichshain-Kreuzberg;1A;B;021A;01;83;W;0;0;0;0;362;362;0;362;294;68;;Group 1
;Stimme;02B1AA;02;Friedrichshain-Kreuzberg;1AA;B;021AA;01;83;W;0;0;0;0;283;283;0;283;224;59;;Group 1
;Stimme;02B1AB;02;Friedrichshain-Kreuzberg;1AB;B;021AB;01;83;W;0;0;0;0;306;306;0;306;215;91;;Group 1
;Stimme;02B1B;02;Friedrichshain-Kreuzberg;1B;B;021B;01;83;W;0;0;0;0;114;114;2;112;78;34;;Group 1
;Stimme;02B1C;02;Friedrichshain-Kreuzberg;1C;B;021C;01;83;W;0;0;0;0;73;73;2;71;46;25;;Group 1
;Stimme;02B1D;02;Friedrichshain-Kreuzberg;1D;B;021D;01;83;W;0;0;0;0;76;76;0;76;54;22;;Group 1
;Stimme;02B1E;02;Friedrichshain-Kreuzberg;1E;B;021E;01;83;W;0;0;0;0;84;84;1;83;56;27;;Group 1
;Stimme;02B1F;02;Friedrichshain-Kreuzberg;1F;B;021F;01;83;W;0;0;0;0;170;170;0;170;105;65;;Group 1
;Stimme;02B1G;02;Friedrichshain-Kreuzberg;1G;B;021G;01;83;W;0;0;0;0;293;293;0;293;189;104;;Group 1
;Stimme;02B1H;02;Friedrichshain-Kreuzberg;1H;B;021H;01;83;W;0;0;0;0;224;224;0;224;171;53;;Group 1
;Stimme;02B1J;02;Friedrichshain-Kreuzberg;1J;B;021J;01;83;W;0;0;0;0;240;240;0;240;187;53;;Group 1
;Stimme;02B1K;02;Friedrichshain-Kreuzberg;1K;B;021K;01;83;W;0;0;0;0;210;210;1;209;172;37;;Group 1
;Stimme;02B1L;02;Friedrichshain-Kreuzberg;1L;B;021L;01;83;W;0;0;0;0;234;234;0;234;185;49;;Group 1
;Stimme;02B1M;02;Friedrichshain-Kreuzberg;1M;B;021M;01;83;W;0;0;0;0;194;194;0;194;152;42;;Group 1
;Stimme;02B1N;02;Friedrichshain-Kreuzberg;1N;B;021N;01;83;W;0;0;0;0;316;316;1;315;248;67;;Group 1
;Stimme;02B1P;02;Friedrichshain-Kreuzberg;1P;B;021P;01;83;W;0;0;0;0;190;190;0;190;145;45;;Group 1
;Stimme;02B1Q;02;Friedrichshain-Kreuzberg;1Q;B;021Q;01;83;W;0;0;0;0;191;191;0;191;158;33;;Group 1
;Stimme;02B1R;02;Friedrichshain-Kreuzberg;1R;B;021R;01;83;W;0;0;0;0;232;232;0;232;178;54;;Group 1
;Stimme;02B1S;02;Friedrichshain-Kreuzberg;1S;B;021S;01;83;W;0;0;0;0;181;181;0;181;130;51;;Group 1
;Stimme;02B1T;02;Friedrichshain-Kreuzberg;1T;B;021T;01;83;W;0;0;0;0;130;130;0;130;108;22;;Group 1
;Stimme;02B1U;02;Friedrichshain-Kreuzberg;1U;B;021U;01;83;W;0;0;0;0;122;122;0;122;97;25;;Group 1
;Stimme;02B1V;02;Friedrichshain-Kreuzberg;1V;B;021V;01;83;W;0;0;0;0;168;168;1;167;140;27;;Group 1
;Stimme;02B1W;02;Friedrichshain-Kreuzberg;1W;B;021W;01;83;W;0;0;0;0;255;255;1;254;189;65;;Group 1
;Stimme;02B1X;02;Friedrichshain-Kreuzberg;1X;B;021X;01;83;W;0;0;0;0;294;294;1;293;254;39;;Group 1
;Stimme;02B1Y;02;Friedrichshain-Kreuzberg;1Y;B;021Y;01;83;W;0;0;0;0;166;166;1;165;119;46;;Group 1
;Stimme;02B1Z;02;Friedrichshain-Kreuzberg;1Z;B;021Z;01;83;W;0;0;0;0;146;146;1;145;123;22;;Group 1
;Stimme;02B2A;02;Friedrichshain-Kreuzberg;2A;B;022A;02;83;W;0;0;0;0;116;116;1;115;94;21;;Group 1
;Stimme;02B2B;02;Friedrichshain-Kreuzberg;2B;B;022B;02;83;W;0;0;0;0;183;183;1;182;156;26;;Group 1
;Stimme;02B2C;02;Friedrichshain-Kreuzberg;2C;B;022C;02;83;W;0;0;0;0;153;153;0;153;129;24;;Group 1
;Stimme;02B2D;02;Friedrichshain-Kreuzberg;2D;B;022D;02;83;W;0;0;0;0;158;158;0;158;138;20;;Group 1
;Stimme;02B2E;02;Friedrichshain-Kreuzberg;2E;B;022E;02;83;W;0;0;0;0;150;150;0;150;135;15;;Group 1
;Stimme;02B2F;02;Friedrichshain-Kreuzberg;2F;B;022F;02;83;W;0;0;0;0;149;149;1;148;130;18;;Group 1
;Stimme;02B2G;02;Friedrichshain-Kreuzberg;2G;B;022G;02;83;W;0;0;0;0;189;189;0;189;164;25;;Group 1
;Stimme;02B2H;02;Friedrichshain-Kreuzberg;2H;B;022H;02;83;W;0;0;0;0;191;191;0;191;155;36;;Group 1
;Stimme;02B2J;02;Friedrichshain-Kreuzberg;2J;B;022J;02;83;W;0;0;0;0;182;182;1;181;156;25;;Group 1
;Stimme;02B2K;02;Friedrichshain-Kreuzberg;2K;B;022K;02;83;W;0;0;0;0;208;208;1;207;189;18;;Group 1
;Stimme;02B2L;02;Friedrichshain-Kreuzberg;2L;B;022L;02;83;W;0;0;0;0;180;180;0;180;156;24;;Group 1
;Stimme;02B2M;02;Friedrichshain-Kreuzberg;2M;B;022M;02;83;W;0;0;0;0;169;169;2;167;141;26;;Group 1
;Stimme;02B2N;02;Friedrichshain-Kreuzberg;2N;B;022N;02;83;W;0;0;0;0;173;173;0;173;144;29;;Group 1
;Stimme;02B2P;02;Friedrichshain-Kreuzberg;2P;B;022P;02;83;W;0;0;0;0;114;114;0;114;97;17;;Group 1
;Stimme;02B2Q;02;Friedrichshain-Kreuzberg;2Q;B;022Q;02;83;W;0;0;0;0;216;216;0;216;181;35;;Group 1
;Stimme;02B2R;02;Friedrichshain-Kreuzberg;2R;B;022R;02;83;W;0;0;0;0;209;209;2;207;175;32;;Group 1
;Stimme;02B2S;02;Friedrichshain-Kreuzberg;2S;B;022S;02;83;W;0;0;0;0;208;208;1;207;181;26;;Group 1
;Stimme;02B2T;02;Friedrichshain-Kreuzberg;2T;B;022T;02;83;W;0;0;0;0;154;154;0;154;115;39;;Group 1
;Stimme;02B2U;02;Friedrichshain-Kreuzberg;2U;B;022U;02;83;W;0;0;0;0;198;198;0;198;165;33;;Group 1
;Stimme;02B2V;02;Friedrichshain-Kreuzberg;2V;B;022V;02;83;W;0;0;0;0;142;142;1;141;121;20;;Group 1
;Stimme;02B2W;02;Friedrichshain-Kreuzberg;2W;B;022W;02;83;W;0;0;0;0;173;173;0;173;150;23;;Group 1
;Stimme;02B2X;02;Friedrichshain-Kreuzberg;2X;B;022X;02;83;W;0;0;0;0;73;73;0;73;57;16;;Group 1
;Stimme;02B2Y;02;Friedrichshain-Kreuzberg;2Y;B;022Y;02;83;W;0;0;0;0;364;364;2;362;285;77;;Group 1
;Stimme;02B2Z;02;Friedrichshain-Kreuzberg;2Z;B;022Z;02;83;W;0;0;0;0;292;292;5;287;216;71;;Group 1
;Stimme;02B3A;02;Friedrichshain-Kreuzberg;3A;B;023A;03;83;W;0;0;0;0;171;171;0;171;138;33;;Group 1
;Stimme;02B3AA;02;Friedrichshain-Kreuzberg;3AA;B;023AA;03;83;W;0;0;0;0;193;193;0;193;176;17;;Group 1
;Stimme;02B3AB;02;Friedrichshain-Kreuzberg;3AB;B;023AB;03;83;W;0;0;0;0;143;143;0;143;120;23;;Group 1
;Stimme;02B3B;02;Friedrichshain-Kreuzberg;3B;B;023B;03;83;W;0;0;0;0;265;265;0;265;211;54;;Group 1
;Stimme;02B3C;02;Friedrichshain-Kreuzberg;3C;B;023C;03;83;W;0;0;0;0;224;224;1;223;173;50;;Group 1
;Stimme;02B3D;02;Friedrichshain-Kreuzberg;3D;B;023D;03;83;W;0;0;0;0;210;210;1;209;170;39;;Group 1
;Stimme;02B3E;02;Friedrichshain-Kreuzberg;3E;B;023E;03;83;W;0;0;0;0;199;199;3;196;158;38;;Group 1
;Stimme;02B3F;02;Friedrichshain-Kreuzberg;3F;B;023F;03;83;W;0;0;0;0;171;171;0;171;132;39;;Group 1
;Stimme;02B3G;02;Friedrichshain-Kreuzberg;3G;B;023G;03;83;W;0;0;0;0;60;60;1;59;46;13;;Group 1
;Stimme;02B3H;02;Friedrichshain-Kreuzberg;3H;B;023H;03;83;W;0;0;0;0;139;139;0;139;100;39;;Group 1
;Stimme;02B3J;02;Friedrichshain-Kreuzberg;3J;B;023J;03;83;W;0;0;0;0;106;106;0;106;70;36;;Group 1
;Stimme;02B3K;02;Friedrichshain-Kreuzberg;3K;B;023K;03;83;W;0;0;0;0;153;153;0;153;94;59;;Group 1
;Stimme;02B3L;02;Friedrichshain-Kreuzberg;3L;B;023L;03;83;W;0;0;0;0;143;143;8;135;98;37;;Group 1
;Stimme;02B3M;02;Friedrichshain-Kreuzberg;3M;B;023M;03;83;W;0;0;0;0;165;165;2;163;128;35;;Group 1
;Stimme;02B3N;02;Friedrichshain-Kreuzberg;3N;B;023N;03;83;W;0;0;0;0;112;112;0;112;64;48;;Group 1
;Stimme;02B3P;02;Friedrichshain-Kreuzberg;3P;B;023P;03;83;W;0;0;0;0;96;96;0;96;76;20;;Group 1
;Stimme;02B3Q;02;Friedrichshain-Kreuzberg;3Q;B;023Q;03;83;W;0;0;0;0;85;85;0;85;50;35;;Group 1
;Stimme;02B3R;02;Friedrichshain-Kreuzberg;3R;B;023R;03;83;W;0;0;0;0;178;178;0;178;158;20;;Group 1
;Stimme;02B3S;02;Friedrichshain-Kreuzberg;3S;B;023S;03;83;W;0;0;0;0;128;128;0;128;100;28;;Group 1
;Stimme;02B3T;02;Friedrichshain-Kreuzberg;3T;B;023T;03;83;W;0;0;0;0;177;177;1;176;150;26;;Group 1
;Stimme;02B3U;02;Friedrichshain-Kreuzberg;3U;B;023U;03;83;W;0;0;0;0;159;159;0;159;145;14;;Group 1
;Stimme;02B3V;02;Friedrichshain-Kreuzberg;3V;B;023V;03;83;W;0;0;0;0;108;108;0;108;90;18;;Group 1
;Stimme;02B3W;02;Friedrichshain-Kreuzberg;3W;B;023W;03;83;W;0;0;0;0;99;99;0;99;84;15;;Group 1
;Stimme;02B3X;02;Friedrichshain-Kreuzberg;3X;B;023X;03;83;W;0;0;0;0;155;155;0;155;125;30;;Group 1
;Stimme;02B3Y;02;Friedrichshain-Kreuzberg;3Y;B;023Y;03;83;W;0;0;0;0;188;188;1;187;152;35;;Group 1
;Stimme;02B3Z;02;Friedrichshain-Kreuzberg;3Z;B;023Z;03;83;W;0;0;0;0;127;127;0;127;94;33;;Group 1
;Stimme;02B4A;02;Friedrichshain-Kreuzberg;4A;B;024A;04;83;O;0;0;0;0;129;129;1;128;67;61;;Group 1
;Stimme;02B4AA;02;Friedrichshain-Kreuzberg;4AA;B;024AA;04;83;O;0;0;0;0;246;246;0;246;193;53;;Group 1
;Stimme;02B4AB;02;Friedrichshain-Kreuzberg;4AB;B;024AB;04;83;O;0;0;0;0;241;241;0;241;180;61;;Group 1
;Stimme;02B4AC;02;Friedrichshain-Kreuzberg;4AC;B;024AC;04;83;O;0;0;0;0;184;184;0;184;129;55;;Group 1
;Stimme;02B4B;02;Friedrichshain-Kreuzberg;4B;B;024B;04;83;O;0;0;0;0;157;157;0;157;77;80;;Group 1
;Stimme;02B4C;02;Friedrichshain-Kreuzberg;4C;B;024C;04;83;O;0;0;0;0;151;151;0;151;75;76;;Group 1
;Stimme;02B4D;02;Friedrichshain-Kreuzberg;4D;B;024D;04;83;O;0;0;0;0;167;167;1;166;87;79;;Group 1
;Stimme;02B4E;02;Friedrichshain-Kreuzberg;4E;B;024E;04;83;O;0;0;0;0;185;185;0;185;117;68;;Group 1
;Stimme;02B4F;02;Friedrichshain-Kreuzberg;4F;B;024F;04;83;O;0;0;0;0;170;170;0;170;123;47;;Group 1
;Stimme;02B4G;02;Friedrichshain-Kreuzberg;4G;B;024G;04;83;O;0;0;0;0;135;135;0;135;95;40;;Group 1
;Stimme;02B4H;02;Friedrichshain-Kreuzberg;4H;B;024H;04;83;O;0;0;0;0;194;194;0;194;134;60;;Group 1
;Stimme;02B4J;02;Friedrichshain-Kreuzberg;4J;B;024J;04;83;O;0;0;0;0;189;189;0;189;115;74;;Group 1
;Stimme;02B4K;02;Friedrichshain-Kreuzberg;4K;B;024K;04;83;O;0;0;0;0;252;252;0;252;177;75;;Group 1
;Stimme;02B4L;02;Friedrichshain-Kreuzberg;4L;B;024L;04;83;O;0;0;0;0;160;160;0;160;85;75;;Group 1
;Stimme;02B4M;02;Friedrichshain-Kreuzberg;4M;B;024M;04;83;O;0;0;0;0;173;173;0;173;123;50;;Group 1
;Stimme;02B4N;02;Friedrichshain-Kreuzberg;4N;B;024N;04;83;O;0;0;0;0;189;189;0;189;147;42;;Group 1
;Stimme;02B4P;02;Friedrichshain-Kreuzberg;4P;B;024P;04;83;O;0;0;0;0;190;190;1;189;130;59;;Group 1
;Stimme;02B4Q;02;Friedrichshain-Kreuzberg;4Q;B;024Q;04;83;O;0;0;0;0;219;219;0;219;161;58;;Group 1
;Stimme;02B4R;02;Friedrichshain-Kreuzberg;4R;B;024R;04;83;O;0;0;0;0;233;233;1;232;137;95;;Group 1
;Stimme;02B4S;02;Friedrichshain-Kreuzberg;4S;B;024S;04;83;O;0;0;0;0;166;166;0;166;113;53;;Group 1
;Stimme;02B4T;02;Friedrichshain-Kreuzberg;4T;B;024T;04;83;O;0;0;0;0;142;142;0;142;68;74;;Group 1
;Stimme;02B4U;02;Friedrichshain-Kreuzberg;4U;B;024U;04;83;O;0;0;0;0;186;186;2;184;102;82;;Group 1
;Stimme;02B4V;02;Friedrichshain-Kreuzberg;4V;B;024V;04;83;O;0;0;0;0;102;102;1;101;51;50;;Group 1
;Stimme;02B4W;02;Friedrichshain-Kreuzberg;4W;B;024W;04;83;O;0;0;0;0;108;108;0;108;53;55;;Group 1
;Stimme;02B4X;02;Friedrichshain-Kreuzberg;4X;B;024X;04;83;O;0;0;0;0;135;135;0;135;89;46;;Group 1
;Stimme;02B4Y;02;Friedrichshain-Kreuzberg;4Y;B;024Y;04;83;O;0;0;0;0;141;141;0;141;77;64;;Group 1
;Stimme;02B4Z;02;Friedrichshain-Kreuzberg;4Z;B;024Z;04;83;O;0;0;0;0;153;153;0;153;94;59;;Group 1
;Stimme;02B5A;02;Friedrichshain-Kreuzberg;5A;B;025A;05;83;O;0;0;0;0;163;163;0;163;136;27;;Group 1
;Stimme;02B5AA;02;Friedrichshain-Kreuzberg;5AA;B;025AA;05;83;O;0;0;0;0;198;198;0;198;158;40;;Group 1
;Stimme;02B5B;02;Friedrichshain-Kreuzberg;5B;B;025B;05;83;O;0;0;0;0;266;266;0;266;197;69;;Group 1
;Stimme;02B5C;02;Friedrichshain-Kreuzberg;5C;B;025C;05;83;O;0;0;0;0;233;233;0;233;179;54;;Group 1
;Stimme;02B5D;02;Friedrichshain-Kreuzberg;5D;B;025D;05;83;O;0;0;0;0;214;214;1;213;172;41;;Group 1
;Stimme;02B5E;02;Friedrichshain-Kreuzberg;5E;B;025E;05;83;O;0;0;0;0;275;275;0;275;230;45;;Group 1
;Stimme;02B5F;02;Friedrichshain-Kreuzberg;5F;B;025F;05;83;O;0;0;0;0;213;213;0;213;171;42;;Group 1
;Stimme;02B5G;02;Friedrichshain-Kreuzberg;5G;B;025G;05;83;O;0;0;0;0;275;275;0;275;224;51;;Group 1
;Stimme;02B5H;02;Friedrichshain-Kreuzberg;5H;B;025H;05;83;O;0;0;0;0;193;193;0;193;144;49;;Group 1
;Stimme;02B5J;02;Friedrichshain-Kreuzberg;5J;B;025J;05;83;O;0;0;0;0;171;171;0;171;140;31;;Group 1
;Stimme;02B5K;02;Friedrichshain-Kreuzberg;5K;B;025K;05;83;O;0;0;0;0;168;168;0;168;139;29;;Group 1
;Stimme;02B5L;02;Friedrichshain-Kreuzberg;5L;B;025L;05;83;O;0;0;0;0;364;364;1;363;292;71;;Group 1
;Stimme;02B5M;02;Friedrichshain-Kreuzberg;5M;B;025M;05;83;O;0;0;0;0;253;253;0;253;219;34;;Group 1
;Stimme;02B5N;02;Friedrichshain-Kreuzberg;5N;B;025N;05;83;O;0;0;0;0;184;184;0;184;152;32;;Group 1
;Stimme;02B5P;02;Friedrichshain-Kreuzberg;5P;B;025P;05;83;O;0;0;0;0;213;213;1;212;177;35;;Group 1
;Stimme;02B5Q;02;Friedrichshain-Kreuzberg;5Q;B;025Q;05;83;O;0;0;0;0;210;210;2;208;154;54;;Group 1
;Stimme;02B5R;02;Friedrichshain-Kreuzberg;5R;B;025R;05;83;O;0;0;0;0;244;244;1;243;189;54;;Group 1
;Stimme;02B5S;02;Friedrichshain-Kreuzberg;5S;B;025S;05;83;O;0;0;0;0;279;279;0;279;212;67;;Group 1
;Stimme;02B5T;02;Friedrichshain-Kreuzberg;5T;B;025T;05;83;O;0;0;0;0;237;237;0;237;180;57;;Group 1
;Stimme;02B5U;02;Friedrichshain-Kreuzberg;5U;B;025U;05;83;O;0;0;0;0;237;237;0;237;180;57;;Group 1
;Stimme;02B5V;02;Friedrichshain-Kreuzberg;5V;B;025V;05;83;O;0;0;0;0;204;204;0;204;159;45;;Group 1
;Stimme;02B5W;02;Friedrichshain-Kreuzberg;5W;B;025W;05;83;O;0;0;0;0;227;227;0;227;179;48;;Group 1
;Stimme;02B5X;02;Friedrichshain-Kreuzberg;5X;B;025X;05;83;O;0;0;0;0;169;169;0;169;130;39;;Group 1
;Stimme;02B5Y;02;Friedrichshain-Kreuzberg;5Y;B;025Y;05;83;O;0;0;0;0;161;161;1;160;119;41;;Group 1
;Stimme;02B5Z;02;Friedrichshain-Kreuzberg;5Z;B;025Z;05;83;O;0;0;0;0;162;162;1;161;131;30;;Group 1
;Stimme;02B6A;02;Friedrichshain-Kreuzberg;6A;B;026A;06;83;O;0;0;0;0;230;230;0;230;164;66;;Group 1
;Stimme;02B6AA;02;Friedrichshain-Kreuzberg;6AA;B;026AA;06;83;O;0;0;0;0;349;349;0;349;290;59;;Group 1
;Stimme;02B6AB;02;Friedrichshain-Kreuzberg;6AB;B;026AB;06;83;O;0;0;0;0;221;221;0;221;155;66;;Group 1
;Stimme;02B6B;02;Friedrichshain-Kreuzberg;6B;B;026B;06;83;O;0;0;0;0;188;188;0;188;111;77;;Group 1
;Stimme;02B6C;02;Friedrichshain-Kreuzberg;6C;B;026C;06;83;O;0;0;0;0;207;207;0;207;164;43;;Group 1
;Stimme;02B6D;02;Friedrichshain-Kreuzberg;6D;B;026D;06;83;O;0;0;0;0;129;129;1;128;80;48;;Group 1
;Stimme;02B6E;02;Friedrichshain-Kreuzberg;6E;B;026E;06;83;O;0;0;0;0;235;235;6;229;191;38;;Group 1
;Stimme;02B6F;02;Friedrichshain-Kreuzberg;6F;B;026F;06;83;O;0;0;0;0;160;160;0;160;130;30;;Group 1
;Stimme;02B6G;02;Friedrichshain-Kreuzberg;6G;B;026G;06;83;O;0;0;0;0;315;315;0;315;240;75;;Group 1
;Stimme;02B6H;02;Friedrichshain-Kreuzberg;6H;B;026H;06;83;O;0;0;0;0;247;247;0;247;207;40;;Group 1
;Stimme;02B6J;02;Friedrichshain-Kreuzberg;6J;B;026J;06;83;O;0;0;0;0;232;232;0;232;189;43;;Group 1
;Stimme;02B6K;02;Friedrichshain-Kreuzberg;6K;B;026K;06;83;O;0;0;0;0;235;235;0;235;174;61;;Group 1
;Stimme;02B6L;02;Friedrichshain-Kreuzberg;6L;B;026L;06;83;O;0;0;0;0;214;214;0;214;178;36;;Group 1
;Stimme;02B6M;02;Friedrichshain-Kreuzberg;6M;B;026M;06;83;O;0;0;0;0;212;212;0;212;171;41;;Group 1
;Stimme;02B6N;02;Friedrichshain-Kreuzberg;6N;B;026N;06;83;O;0;0;0;0;305;305;1;304;255;49;;Group 1
;Stimme;02B6P;02;Friedrichshain-Kreuzberg;6P;B;026P;06;83;O;0;0;0;0;226;226;0;226;180;46;;Group 1
;Stimme;02B6Q;02;Friedrichshain-Kreuzberg;6Q;B;026Q;06;83;O;0;0;0;0;126;126;0;126;99;27;;Group 1
;Stimme;02B6R;02;Friedrichshain-Kreuzberg;6R;B;026R;06;83;O;0;0;0;0;202;202;1;201;164;37;;Group 1
;Stimme;02B6S;02;Friedrichshain-Kreuzberg;6S;B;026S;06;83;O;0;0;0;0;235;235;0;235;194;41;;Group 1
;Stimme;02B6T;02;Friedrichshain-Kreuzberg;6T;B;026T;06;83;O;0;0;0;0;174;174;0;174;151;23;;Group 1
;Stimme;02B6U;02;Friedrichshain-Kreuzberg;6U;B;026U;06;83;O;0;0;0;0;167;167;0;167;137;30;;Group 1
;Stimme;02B6V;02;Friedrichshain-Kreuzberg;6V;B;026V;06;83;O;0;0;0;0;223;223;1;222;181;41;;Group 1
;Stimme;02B6W;02;Friedrichshain-Kreuzberg;6W;B;026W;06;83;O;0;0;0;0;180;180;0;180;153;27;;Group 1
;Stimme;02B6X;02;Friedrichshain-Kreuzberg;6X;B;026X;06;83;O;0;0;0;0;199;199;0;199;170;29;;Group 1
;Stimme;02B6Y;02;Friedrichshain-Kreuzberg;6Y;B;026Y;06;83;O;0;0;0;0;206;206;0;206;169;37;;Group 1
;Stimme;02B6Z;02;Friedrichshain-Kreuzberg;6Z;B;026Z;06;83;O;0;0;0;0;214;214;0;214;165;49;;Group 1
Group 2;;;;;;;;;;;;;;;;;;;;;;
